*******************************
*             *               *
*** *** *** ***** * *** *** ***
*   *     *   *   * *     *   *
* * *** *** ***** ***** *** ***
* * *     * * *     *     *   *
* ***** ***** *** ***** *** * *
*   *   * *         *   * * * *
* ***** * *** * * ***** * *** *
*   *         * * * *       * *
* ***** * * * ***** ***** *** *
*   * * * * * *   * * *   * * *
* *** *********** * * *** * ***
*   *                 *       *
* *** * * ******* *** ***** ***
*   * * * * * * * * *   *     *
* ***** *** * * *** * ***** ***
*     * *         *     *   * *
* * *** *** *** *** *** *** * *
* *   * *   * *       * *     *
*** *** *** * *** * *** ***** *
*     * *       * * *     *  S*
* * *** ***** ********* ***** *
* * *     *     *   *       * *
* *** * ***** ***** *** * *****
*   * * * * *   *     * *   * *
* ******* * * *** *** *** *** *
*     * *       * *           *
* * *** * *** *** *** * * * * *
* *         * *  E  * * * * * *
*******************************