****************
*              E
*  * *    ******
*  * *    *    *
*  * *         *
********  *    *
*      *  *    *
*  *** *  *    *
*    * ****    *
*    *    *    *
*    *    *    *
*S   *         *
****************