*******
*S    *
**** **
*     *
** ****
*    E*
*******
