******
*S   *
**** *
*    *
* ****
*   E*
******